1 0 0 0 0 0 0 0 0 0 2 4 2 4 2 5 2 5 2 5 2 4 2 4 2 5 2 5 2 5 2 4 2 4 2 5 2 5 2 5 2 4 2 4 2 5 2 5 2 5
0 0 0 0 0 0 0 0 0 0 4 4 4 4 5 2 5 5 5 4 4 4 4 4 5 2 5 5 5 4 4 4 4 4 5 2 5 5 5 4 4 4 4 4 5 2 5 5 5 4
0 0 0 0 0 0 0 0 0 0 2 4 4 5 5 5 5 5 4 4 2 4 4 5 5 5 5 5 4 4 2 4 4 5 5 5 5 5 4 4 2 4 4 5 5 5 5 5 4 4
0 0 0 0 0 0 0 0 0 0 4 4 5 5 5 2 5 4 4 4 4 4 5 5 5 2 5 4 4 4 4 4 5 5 5 2 5 4 4 4 4 4 5 5 5 2 5 4 4 4
0 0 0 0 0 0 0 0 0 0 2 5 5 5 5 5 4 4 4 4 2 5 5 5 5 5 4 4 4 4 2 5 5 5 5 5 4 4 4 4 2 5 5 5 5 5 4 4 4 4
0 0 0 0 0 0 0 0 0 0 5 2 5 2 5 2 4 2 4 2 5 2 5 2 5 2 4 2 4 2 5 2 5 2 5 2 4 2 4 2 5 2 5 2 5 2 4 2 4 2
0 0 0 0 0 0 0 0 0 0 2 5 5 5 4 4 4 4 4 5 2 5 5 5 4 4 4 4 4 5 2 5 5 5 4 4 4 4 4 5 2 5 5 5 4 4 4 4 4 5
0 0 0 0 0 0 0 0 0 0 5 5 5 4 4 2 4 4 5 5 5 5 5 4 4 2 4 4 5 5 5 5 5 4 4 2 4 4 5 5 5 5 5 4 4 2 4 4 5 5
0 0 0 0 0 0 0 0 0 0 2 5 4 4 4 4 4 5 5 5 2 5 4 4 4 4 4 5 5 5 2 5 4 4 4 4 4 5 5 5 2 5 4 4 4 4 4 5 5 5
0 0 0 0 0 0 0 0 0 0 5 4 4 4 4 2 5 5 5 5 5 4 4 4 4 2 5 5 5 5 5 4 4 4 4 2 5 5 5 5 5 4 4 4 4 2 5 5 5 5
2 4 2 4 2 5 2 5 2 5 1 1 1 1 1 1 1 1 1 1 2 4 2 4 2 5 2 5 2 5 2 4 2 4 2 5 2 5 2 5 2 4 2 4 2 5 2 5 2 5
4 4 4 4 5 2 5 5 5 4 1 1 1 1 1 1 1 1 1 1 4 4 4 4 5 2 5 5 5 4 4 4 4 4 5 2 5 5 5 4 4 4 4 4 5 2 5 5 5 4
2 4 4 5 5 5 5 5 4 4 1 1 1 1 1 1 1 1 1 1 2 4 4 5 5 5 5 5 4 4 2 4 4 5 5 5 5 5 4 4 2 4 4 5 5 5 5 5 4 4
4 4 5 5 5 2 5 4 4 4 1 1 1 1 1 1 1 1 1 1 4 4 5 5 5 2 5 4 4 4 4 4 5 5 5 2 5 4 4 4 4 4 5 5 5 2 5 4 4 4
2 5 5 5 5 5 4 4 4 4 1 1 1 1 1 1 1 1 1 1 2 5 5 5 5 5 4 4 4 4 2 5 5 5 5 5 4 4 4 4 2 5 5 5 5 5 4 4 4 4
5 2 5 2 5 2 4 2 4 2 1 1 1 1 1 1 1 1 1 1 5 2 5 2 5 2 4 2 4 2 5 2 5 2 5 2 4 2 4 2 5 2 5 2 5 2 4 2 4 2
2 5 5 5 4 4 4 4 4 5 1 1 1 1 1 1 1 1 1 1 2 5 5 5 4 4 4 4 4 5 2 5 5 5 4 4 4 4 4 5 2 5 5 5 4 4 4 4 4 5
5 5 5 4 4 2 4 4 5 5 1 1 1 1 1 1 1 1 1 1 5 5 5 4 4 2 4 4 5 5 5 5 5 4 4 2 4 4 5 5 5 5 5 4 4 2 4 4 5 5
2 5 4 4 4 4 4 5 5 5 1 1 1 1 1 1 1 1 1 1 2 5 4 4 4 4 4 5 5 5 2 5 4 4 4 4 4 5 5 5 2 5 4 4 4 4 4 5 5 5
5 4 4 4 4 2 5 5 5 5 1 1 1 1 1 1 1 1 1 1 5 4 4 4 4 2 5 5 5 5 5 4 4 4 4 2 5 5 5 5 5 4 4 4 4 2 5 5 5 5
2 4 2 4 2 5 2 5 2 5 2 4 2 4 2 5 2 5 2 5 2 3 2 3 2 3 2 3 2 3 2 4 2 4 2 5 2 5 2 5 2 4 2 4 2 5 2 5 2 5
4 4 4 4 5 2 5 5 5 4 4 4 4 4 5 2 5 5 5 4 3 3 3 3 3 2 3 3 3 3 4 4 4 4 5 2 5 5 5 4 4 4 4 4 5 2 5 5 5 4
2 4 4 5 5 5 5 5 4 4 2 4 4 5 5 5 5 5 4 4 2 3 3 3 3 3 3 3 3 3 2 4 4 5 5 5 5 5 4 4 2 4 4 5 5 5 5 5 4 4
4 4 5 5 5 2 5 4 4 4 4 4 5 5 5 2 5 4 4 4 3 3 3 3 3 2 3 3 3 3 4 4 5 5 5 2 5 4 4 4 4 4 5 5 5 2 5 4 4 4
2 5 5 5 5 5 4 4 4 4 2 5 5 5 5 5 4 4 4 4 2 3 3 3 3 3 3 3 3 3 2 5 5 5 5 5 4 4 4 4 2 5 5 5 5 5 4 4 4 4
5 2 5 2 5 2 4 2 4 2 5 2 5 2 5 2 4 2 4 2 3 2 3 2 3 2 3 2 3 2 5 2 5 2 5 2 4 2 4 2 5 2 5 2 5 2 4 2 4 2
2 5 5 5 4 4 4 4 4 5 2 5 5 5 4 4 4 4 4 5 2 3 3 3 3 3 3 3 3 3 2 5 5 5 4 4 4 4 4 5 2 5 5 5 4 4 4 4 4 5
5 5 5 4 4 2 4 4 5 5 5 5 5 4 4 2 4 4 5 5 3 3 3 3 3 2 3 3 3 3 5 5 5 4 4 2 4 4 5 5 5 5 5 4 4 2 4 4 5 5
2 5 4 4 4 4 4 5 5 5 2 5 4 4 4 4 4 5 5 5 2 3 3 3 3 3 3 3 3 3 2 5 4 4 4 4 4 5 5 5 2 5 4 4 4 4 4 5 5 5
5 4 4 4 4 2 5 5 5 5 5 4 4 4 4 2 5 5 5 5 3 3 3 3 3 2 3 3 3 3 5 4 4 4 4 2 5 5 5 5 5 4 4 4 4 2 5 5 5 5
2 4 2 4 2 5 2 5 2 5 2 4 2 4 2 5 2 5 2 5 2 4 2 4 2 5 2 5 2 5 1 1 1 1 1 1 1 1 1 1 2 4 2 4 2 5 2 5 2 5
4 4 4 4 5 2 5 5 5 4 4 4 4 4 5 2 5 5 5 4 4 4 4 4 5 2 5 5 5 4 1 1 1 1 1 1 1 1 1 1 4 4 4 4 5 2 5 5 5 4
2 4 4 5 5 5 5 5 4 4 2 4 4 5 5 5 5 5 4 4 2 4 4 5 5 5 5 5 4 4 1 1 1 1 1 1 1 1 1 1 2 4 4 5 5 5 5 5 4 4
4 4 5 5 5 2 5 4 4 4 4 4 5 5 5 2 5 4 4 4 4 4 5 5 5 2 5 4 4 4 1 1 1 1 1 1 1 1 1 1 4 4 5 5 5 2 5 4 4 4
2 5 5 5 5 5 4 4 4 4 2 5 5 5 5 5 4 4 4 4 2 5 5 5 5 5 4 4 4 4 1 1 1 1 1 1 1 1 1 1 2 5 5 5 5 5 4 4 4 4
5 2 5 2 5 2 4 2 4 2 5 2 5 2 5 2 4 2 4 2 5 2 5 2 5 2 4 2 4 2 1 1 1 1 1 1 1 1 1 1 5 2 5 2 5 2 4 2 4 2
2 5 5 5 4 4 4 4 4 5 2 5 5 5 4 4 4 4 4 5 2 5 5 5 4 4 4 4 4 5 1 1 1 1 1 1 1 1 1 1 2 5 5 5 4 4 4 4 4 5
5 5 5 4 4 2 4 4 5 5 5 5 5 4 4 2 4 4 5 5 5 5 5 4 4 2 4 4 5 5 1 1 1 1 1 1 1 1 1 1 5 5 5 4 4 2 4 4 5 5
2 5 4 4 4 4 4 5 5 5 2 5 4 4 4 4 4 5 5 5 2 5 4 4 4 4 4 5 5 5 1 1 1 1 1 1 1 1 1 1 2 5 4 4 4 4 4 5 5 5
5 4 4 4 4 2 5 5 5 5 5 4 4 4 4 2 5 5 5 5 5 4 4 4 4 2 5 5 5 5 1 1 1 1 1 1 1 1 1 1 5 4 4 4 4 2 5 5 5 5
2 4 2 4 2 5 2 5 2 5 2 4 2 4 2 5 2 5 2 5 2 4 2 4 2 5 2 5 2 5 2 4 2 4 2 5 2 5 2 5 2 4 2 4 2 5 2 5 2 5
4 4 4 4 5 2 5 5 5 4 4 4 4 4 5 2 5 5 5 4 4 4 4 4 5 2 5 5 5 4 4 4 4 4 5 2 5 5 5 4 4 0 0 0 0 0 0 0 0 0
2 4 4 5 5 5 5 5 4 4 2 4 4 5 5 5 5 5 4 4 2 4 4 5 5 5 5 5 4 4 2 4 4 5 5 5 5 5 4 4 2 0 0 0 0 0 0 0 0 0
4 4 5 5 5 2 5 4 4 4 4 4 5 5 5 2 5 4 4 4 4 4 5 5 5 2 5 4 4 4 4 4 5 5 5 2 5 4 4 4 4 0 0 0 0 0 0 0 0 0
2 5 5 5 5 5 4 4 4 4 2 5 5 5 5 5 4 4 4 4 2 5 5 5 5 5 4 4 4 4 2 5 5 5 5 5 4 4 4 4 2 0 0 0 0 0 0 0 0 0
5 2 5 2 5 2 4 2 4 2 5 2 5 2 5 2 4 2 4 2 5 2 5 2 5 2 4 2 4 2 5 2 5 2 5 2 4 2 4 2 5 0 0 0 0 0 0 0 0 0
2 5 5 5 4 4 4 4 4 5 2 5 5 5 4 4 4 4 4 5 2 5 5 5 4 4 4 4 4 5 2 5 5 5 4 4 4 4 4 5 2 0 0 0 0 0 0 0 0 0
5 5 5 4 4 2 4 4 5 5 5 5 5 4 4 2 4 4 5 5 5 5 5 4 4 2 4 4 5 5 5 5 5 4 4 2 4 4 5 5 5 0 0 0 0 0 0 0 0 0
2 5 4 4 4 4 4 5 5 5 2 5 4 4 4 4 4 5 5 5 2 5 4 4 4 4 4 5 5 5 2 5 4 4 4 4 4 5 5 5 2 0 0 0 0 0 0 0 0 0
5 4 4 4 4 2 5 5 5 5 5 4 4 4 4 2 5 5 5 5 5 4 4 4 4 2 5 5 5 5 5 4 4 4 4 2 5 5 5 5 5 0 0 0 0 0 0 0 0 0